10
G.G.-.B.P.B.-.-.-.-
G.G.S.B.P.B.-.-.G.-
-.BS.W.SB.P.B.-.-.-.-
B.P.BS.-.B.-.-.-.-.-
P.B.-.-.-.-.-.-.-.-
B.-.-.-.-.-.-.-.-.-
-.-.-.-.-.-.-.-.-.-
-.-.-.-.-.-.-.G.-.-
-.-.-.-.-.-.-.-.-.-
A.-.-.-.-.-.-.-.-.-
